dungeon
10
8
6
8
0,0,0,0,0,0,0,1,1,0
0,1,1,1,1,1,1,1,1,0
0,1,0,1,1,1,1,0,0,0
0,1,0,1,1,0,1,1,0,0
0,1,1,0,1,0,0,1,1,0
1,1,1,1,1,1,1,1,1,1
1,1,1,1,1,1,0,1,1,0
0,0,1,0,1,1,0,0,0,0
[NPC]
1
8
girl
I'm Bianca. How are you doing?
[ACTIONS]
village
5
8
16
10
[SPAWNPOINTS]
